FE6 - Bridge - 014c4d4e
10 15
172 172 172 172 172 172 172 172 172 172 172 172 172 172 244
172 172 172 172 172 172 172 172 172 172 172 172 172 172 244
172 172 172 172 172 172 172 172 172 172 172 172 172 172 244
172 172 172 172 172 172 172 172 172 172 172 172 172 244 244
244 244 244 172 172 172 172 172 172 172 172 172 244 244 244
172 172 244 244 172 172 172 172 172 172 172 244 244 172 244
172 172 172 244 244 244 172 172 172 172 244 244 172 172 244
172 172 172 172 172 244 244 244 172 244 244 172 172 172 244
172 172 172 172 172 172 172 244 244 244 172 172 172 172 244
172 172 172 172 172 172 172 244 244 172 172 172 172 172 244
